"filename", "language", "Java", "XML", "comment", "blank", "total"
"c:\Users\helio\OneDrive\Área de Trabalho\Estudando Programação Avançada\3\gestaoempresarial\pom.xml", "XML", 0, 102, 7, 12, 121
"c:\Users\helio\OneDrive\Área de Trabalho\Estudando Programação Avançada\3\gestaoempresarial\src\main\Resources\META-INF\Persistence.xml", "XML", 0, 20, 3, 5, 28
"c:\Users\helio\OneDrive\Área de Trabalho\Estudando Programação Avançada\3\gestaoempresarial\src\main\java\com\helio\App.java", "Java", 12, 0, 0, 5, 17
"c:\Users\helio\OneDrive\Área de Trabalho\Estudando Programação Avançada\3\gestaoempresarial\src\main\java\com\helio\dao\ContaPoupancaDao.java", "Java", 83, 0, 2, 27, 112
"c:\Users\helio\OneDrive\Área de Trabalho\Estudando Programação Avançada\3\gestaoempresarial\src\main\java\com\helio\dao\FuncionarioDao.java", "Java", 80, 0, 3, 29, 112
"c:\Users\helio\OneDrive\Área de Trabalho\Estudando Programação Avançada\3\gestaoempresarial\src\main\java\com\helio\dao\PessoaDao.java", "Java", 63, 0, 0, 23, 86
"c:\Users\helio\OneDrive\Área de Trabalho\Estudando Programação Avançada\3\gestaoempresarial\src\main\java\com\helio\models\ContaBancaria.java", "Java", 36, 0, 0, 9, 45
"c:\Users\helio\OneDrive\Área de Trabalho\Estudando Programação Avançada\3\gestaoempresarial\src\main\java\com\helio\models\ContaPoupanca.java", "Java", 34, 0, 2, 8, 44
"c:\Users\helio\OneDrive\Área de Trabalho\Estudando Programação Avançada\3\gestaoempresarial\src\main\java\com\helio\models\Funcionario.java", "Java", 54, 0, 0, 10, 64
"c:\Users\helio\OneDrive\Área de Trabalho\Estudando Programação Avançada\3\gestaoempresarial\src\main\java\com\helio\models\Pessoa.java", "Java", 28, 0, 1, 4, 33
"c:\Users\helio\OneDrive\Área de Trabalho\Estudando Programação Avançada\3\gestaoempresarial\src\main\java\com\helio\ui\InternoSubMenuPessoa.java", "Java", 124, 0, 4, 15, 143
"c:\Users\helio\OneDrive\Área de Trabalho\Estudando Programação Avançada\3\gestaoempresarial\src\main\java\com\helio\ui\Menu.java", "Java", 51, 0, 1, 11, 63
"c:\Users\helio\OneDrive\Área de Trabalho\Estudando Programação Avançada\3\gestaoempresarial\src\main\java\com\helio\ui\MenuTipoContas.java", "Java", 36, 0, 1, 11, 48
"c:\Users\helio\OneDrive\Área de Trabalho\Estudando Programação Avançada\3\gestaoempresarial\src\main\java\com\helio\ui\SubmenuContaPoupanca.java", "Java", 162, 0, 3, 46, 211
"c:\Users\helio\OneDrive\Área de Trabalho\Estudando Programação Avançada\3\gestaoempresarial\src\main\java\com\helio\ui\SubmenuFuncionarios.java", "Java", 204, 0, 8, 58, 270
"c:\Users\helio\OneDrive\Área de Trabalho\Estudando Programação Avançada\3\gestaoempresarial\src\main\java\com\helio\ui\SubmenuPessoa.java", "Java", 202, 0, 10, 29, 241
"c:\Users\helio\OneDrive\Área de Trabalho\Estudando Programação Avançada\3\gestaoempresarial\src\main\java\com\helio\utilities\CabecalhoPadrao.java", "Java", 21, 0, 1, 7, 29
"c:\Users\helio\OneDrive\Área de Trabalho\Estudando Programação Avançada\3\gestaoempresarial\src\main\java\com\helio\utilities\EntityManagerUtil.java", "Java", 24, 0, 3, 7, 34
"c:\Users\helio\OneDrive\Área de Trabalho\Estudando Programação Avançada\3\gestaoempresarial\src\main\java\com\helio\utilities\Pausa.java", "Java", 11, 0, 0, 4, 15
"c:\Users\helio\OneDrive\Área de Trabalho\Estudando Programação Avançada\3\gestaoempresarial\src\main\java\com\helio\utilities\ResetaTerminal.java", "Java", 10, 0, 0, 2, 12
"c:\Users\helio\OneDrive\Área de Trabalho\Estudando Programação Avançada\3\gestaoempresarial\src\main\java\com\helio\utilities\Validacao.java", "Java", 145, 0, 0, 34, 179
"c:\Users\helio\OneDrive\Área de Trabalho\Estudando Programação Avançada\3\gestaoempresarial\src\test\java\com\helio\AppTest.java", "Java", 11, 0, 6, 4, 21
"c:\Users\helio\OneDrive\Área de Trabalho\Estudando Programação Avançada\3\gestaoempresarial\src\test\java\com\helio\ui\SubmenuPessoaTest.java", "Java", 14, 0, 1, 6, 21
"c:\Users\helio\OneDrive\Área de Trabalho\Estudando Programação Avançada\3\gestaoempresarial\target\classes\META-INF\Persistence.xml", "XML", 0, 20, 3, 5, 28
"c:\Users\helio\OneDrive\Área de Trabalho\Estudando Programação Avançada\3\gestaoempresarial\target\classes\com\helio\App.class", "Java", 10, 0, 0, 0, 10
"c:\Users\helio\OneDrive\Área de Trabalho\Estudando Programação Avançada\3\gestaoempresarial\target\classes\com\helio\dao\ContaPoupancaDao.class", "Java", 30, 0, 0, 0, 30
"c:\Users\helio\OneDrive\Área de Trabalho\Estudando Programação Avançada\3\gestaoempresarial\target\classes\com\helio\dao\FuncionarioDao.class", "Java", 28, 0, 0, 0, 28
"c:\Users\helio\OneDrive\Área de Trabalho\Estudando Programação Avançada\3\gestaoempresarial\target\classes\com\helio\dao\PessoaDao.class", "Java", 29, 0, 0, 0, 29
"c:\Users\helio\OneDrive\Área de Trabalho\Estudando Programação Avançada\3\gestaoempresarial\target\classes\com\helio\models\ContaBancaria.class", "Java", 26, 0, 0, 0, 26
"c:\Users\helio\OneDrive\Área de Trabalho\Estudando Programação Avançada\3\gestaoempresarial\target\classes\com\helio\models\ContaPoupanca.class", "Java", 14, 0, 0, 0, 14
"c:\Users\helio\OneDrive\Área de Trabalho\Estudando Programação Avançada\3\gestaoempresarial\target\classes\com\helio\models\Funcionario.class", "Java", 29, 0, 0, 0, 29
"c:\Users\helio\OneDrive\Área de Trabalho\Estudando Programação Avançada\3\gestaoempresarial\target\classes\com\helio\models\Pessoa.class", "Java", 9, 0, 0, 0, 9
"c:\Users\helio\OneDrive\Área de Trabalho\Estudando Programação Avançada\3\gestaoempresarial\target\classes\com\helio\ui\InternoSubMenuPessoa.class", "Java", 40, 0, 0, 1, 41
"c:\Users\helio\OneDrive\Área de Trabalho\Estudando Programação Avançada\3\gestaoempresarial\target\classes\com\helio\ui\Menu.class", "Java", 25, 0, 0, 0, 25
"c:\Users\helio\OneDrive\Área de Trabalho\Estudando Programação Avançada\3\gestaoempresarial\target\classes\com\helio\ui\MenuTipoContas.class", "Java", 17, 0, 0, 0, 17
"c:\Users\helio\OneDrive\Área de Trabalho\Estudando Programação Avançada\3\gestaoempresarial\target\classes\com\helio\ui\SubmenuContaPoupanca.class", "Java", 66, 0, 0, 1, 67
"c:\Users\helio\OneDrive\Área de Trabalho\Estudando Programação Avançada\3\gestaoempresarial\target\classes\com\helio\ui\SubmenuFuncionarios.class", "Java", 78, 0, 0, 0, 78
"c:\Users\helio\OneDrive\Área de Trabalho\Estudando Programação Avançada\3\gestaoempresarial\target\classes\com\helio\ui\SubmenuPessoa.class", "Java", 57, 0, 0, 0, 57
"c:\Users\helio\OneDrive\Área de Trabalho\Estudando Programação Avançada\3\gestaoempresarial\target\classes\com\helio\utilities\CabecalhoPadrao.class", "Java", 18, 0, 0, 0, 18
"c:\Users\helio\OneDrive\Área de Trabalho\Estudando Programação Avançada\3\gestaoempresarial\target\classes\com\helio\utilities\EntityManagerUtil.class", "Java", 16, 0, 0, 0, 16
"c:\Users\helio\OneDrive\Área de Trabalho\Estudando Programação Avançada\3\gestaoempresarial\target\classes\com\helio\utilities\Pausa.class", "Java", 13, 0, 0, 0, 13
"c:\Users\helio\OneDrive\Área de Trabalho\Estudando Programação Avançada\3\gestaoempresarial\target\classes\com\helio\utilities\ResetaTerminal.class", "Java", 18, 0, 0, 0, 18
"c:\Users\helio\OneDrive\Área de Trabalho\Estudando Programação Avançada\3\gestaoempresarial\target\classes\com\helio\utilities\Validacao.class", "Java", 68, 0, 0, 0, 68
"c:\Users\helio\OneDrive\Área de Trabalho\Estudando Programação Avançada\3\gestaoempresarial\target\test-classes\com\helio\AppTest.class", "Java", 11, 0, 0, 0, 11
"c:\Users\helio\OneDrive\Área de Trabalho\Estudando Programação Avançada\3\gestaoempresarial\target\test-classes\com\helio\ui\SubmenuPessoaTest.class", "Java", 23, 0, 0, 0, 23
"Total", "-", 2030, 142, 59, 373, 2604