"filename", "language", "XML", "Java", "comment", "blank", "total"
"c:\Users\helio\OneDrive\Área de Trabalho\Estudando Programação Avançada\3\gestaoempresarial\pom.xml", "XML", 102, 0, 7, 12, 121
"c:\Users\helio\OneDrive\Área de Trabalho\Estudando Programação Avançada\3\gestaoempresarial\src\main\Resources\META-INF\Persistence.xml", "XML", 20, 0, 3, 5, 28
"c:\Users\helio\OneDrive\Área de Trabalho\Estudando Programação Avançada\3\gestaoempresarial\src\main\java\com\helio\App.java", "Java", 0, 12, 0, 5, 17
"c:\Users\helio\OneDrive\Área de Trabalho\Estudando Programação Avançada\3\gestaoempresarial\src\main\java\com\helio\dao\ContaPoupancaDao.java", "Java", 0, 83, 2, 27, 112
"c:\Users\helio\OneDrive\Área de Trabalho\Estudando Programação Avançada\3\gestaoempresarial\src\main\java\com\helio\dao\EmpresaDao.java", "Java", 0, 84, 0, 27, 111
"c:\Users\helio\OneDrive\Área de Trabalho\Estudando Programação Avançada\3\gestaoempresarial\src\main\java\com\helio\dao\FuncionarioDao.java", "Java", 0, 85, 4, 30, 119
"c:\Users\helio\OneDrive\Área de Trabalho\Estudando Programação Avançada\3\gestaoempresarial\src\main\java\com\helio\dao\PessoaDao.java", "Java", 0, 63, 0, 23, 86
"c:\Users\helio\OneDrive\Área de Trabalho\Estudando Programação Avançada\3\gestaoempresarial\src\main\java\com\helio\models\ContaBancaria.java", "Java", 0, 36, 0, 9, 45
"c:\Users\helio\OneDrive\Área de Trabalho\Estudando Programação Avançada\3\gestaoempresarial\src\main\java\com\helio\models\ContaPoupanca.java", "Java", 0, 34, 2, 8, 44
"c:\Users\helio\OneDrive\Área de Trabalho\Estudando Programação Avançada\3\gestaoempresarial\src\main\java\com\helio\models\Empresa.java", "Java", 0, 36, 0, 10, 46
"c:\Users\helio\OneDrive\Área de Trabalho\Estudando Programação Avançada\3\gestaoempresarial\src\main\java\com\helio\models\Funcionario.java", "Java", 0, 60, 0, 12, 72
"c:\Users\helio\OneDrive\Área de Trabalho\Estudando Programação Avançada\3\gestaoempresarial\src\main\java\com\helio\models\Pessoa.java", "Java", 0, 28, 1, 4, 33
"c:\Users\helio\OneDrive\Área de Trabalho\Estudando Programação Avançada\3\gestaoempresarial\src\main\java\com\helio\ui\InternoSubMenuPessoa.java", "Java", 0, 124, 4, 15, 143
"c:\Users\helio\OneDrive\Área de Trabalho\Estudando Programação Avançada\3\gestaoempresarial\src\main\java\com\helio\ui\Menu.java", "Java", 0, 50, 1, 11, 62
"c:\Users\helio\OneDrive\Área de Trabalho\Estudando Programação Avançada\3\gestaoempresarial\src\main\java\com\helio\ui\MenuTipoContas.java", "Java", 0, 36, 1, 11, 48
"c:\Users\helio\OneDrive\Área de Trabalho\Estudando Programação Avançada\3\gestaoempresarial\src\main\java\com\helio\ui\SubmenuContaPoupanca.java", "Java", 0, 162, 3, 46, 211
"c:\Users\helio\OneDrive\Área de Trabalho\Estudando Programação Avançada\3\gestaoempresarial\src\main\java\com\helio\ui\SubmenuEmpresa.java", "Java", 0, 111, 0, 40, 151
"c:\Users\helio\OneDrive\Área de Trabalho\Estudando Programação Avançada\3\gestaoempresarial\src\main\java\com\helio\ui\SubmenuFuncionarios.java", "Java", 0, 206, 8, 57, 271
"c:\Users\helio\OneDrive\Área de Trabalho\Estudando Programação Avançada\3\gestaoempresarial\src\main\java\com\helio\ui\SubmenuPessoa.java", "Java", 0, 202, 10, 29, 241
"c:\Users\helio\OneDrive\Área de Trabalho\Estudando Programação Avançada\3\gestaoempresarial\src\main\java\com\helio\utilities\CabecalhoPadrao.java", "Java", 0, 21, 1, 7, 29
"c:\Users\helio\OneDrive\Área de Trabalho\Estudando Programação Avançada\3\gestaoempresarial\src\main\java\com\helio\utilities\EntityManagerUtil.java", "Java", 0, 24, 3, 7, 34
"c:\Users\helio\OneDrive\Área de Trabalho\Estudando Programação Avançada\3\gestaoempresarial\src\main\java\com\helio\utilities\Pausa.java", "Java", 0, 11, 0, 4, 15
"c:\Users\helio\OneDrive\Área de Trabalho\Estudando Programação Avançada\3\gestaoempresarial\src\main\java\com\helio\utilities\ResetaTerminal.java", "Java", 0, 10, 0, 2, 12
"c:\Users\helio\OneDrive\Área de Trabalho\Estudando Programação Avançada\3\gestaoempresarial\src\main\java\com\helio\utilities\Validacao.java", "Java", 0, 152, 0, 36, 188
"c:\Users\helio\OneDrive\Área de Trabalho\Estudando Programação Avançada\3\gestaoempresarial\src\test\java\com\helio\AppTest.java", "Java", 0, 11, 6, 4, 21
"c:\Users\helio\OneDrive\Área de Trabalho\Estudando Programação Avançada\3\gestaoempresarial\src\test\java\com\helio\ui\SubmenuPessoaTest.java", "Java", 0, 14, 1, 6, 21
"c:\Users\helio\OneDrive\Área de Trabalho\Estudando Programação Avançada\3\gestaoempresarial\target\classes\META-INF\Persistence.xml", "XML", 20, 0, 3, 5, 28
"c:\Users\helio\OneDrive\Área de Trabalho\Estudando Programação Avançada\3\gestaoempresarial\target\classes\com\helio\App.class", "Java", 0, 10, 0, 0, 10
"c:\Users\helio\OneDrive\Área de Trabalho\Estudando Programação Avançada\3\gestaoempresarial\target\classes\com\helio\dao\ContaPoupancaDao.class", "Java", 0, 30, 0, 0, 30
"c:\Users\helio\OneDrive\Área de Trabalho\Estudando Programação Avançada\3\gestaoempresarial\target\classes\com\helio\dao\EmpresaDao.class", "Java", 0, 29, 0, 0, 29
"c:\Users\helio\OneDrive\Área de Trabalho\Estudando Programação Avançada\3\gestaoempresarial\target\classes\com\helio\dao\FuncionarioDao.class", "Java", 0, 27, 0, 0, 27
"c:\Users\helio\OneDrive\Área de Trabalho\Estudando Programação Avançada\3\gestaoempresarial\target\classes\com\helio\dao\PessoaDao.class", "Java", 0, 29, 0, 0, 29
"c:\Users\helio\OneDrive\Área de Trabalho\Estudando Programação Avançada\3\gestaoempresarial\target\classes\com\helio\models\ContaBancaria.class", "Java", 0, 26, 0, 0, 26
"c:\Users\helio\OneDrive\Área de Trabalho\Estudando Programação Avançada\3\gestaoempresarial\target\classes\com\helio\models\ContaPoupanca.class", "Java", 0, 14, 0, 0, 14
"c:\Users\helio\OneDrive\Área de Trabalho\Estudando Programação Avançada\3\gestaoempresarial\target\classes\com\helio\models\Empresa.class", "Java", 0, 19, 0, 0, 19
"c:\Users\helio\OneDrive\Área de Trabalho\Estudando Programação Avançada\3\gestaoempresarial\target\classes\com\helio\models\Funcionario.class", "Java", 0, 32, 0, 0, 32
"c:\Users\helio\OneDrive\Área de Trabalho\Estudando Programação Avançada\3\gestaoempresarial\target\classes\com\helio\models\Pessoa.class", "Java", 0, 9, 0, 0, 9
"c:\Users\helio\OneDrive\Área de Trabalho\Estudando Programação Avançada\3\gestaoempresarial\target\classes\com\helio\ui\InternoSubMenuPessoa.class", "Java", 0, 40, 0, 1, 41
"c:\Users\helio\OneDrive\Área de Trabalho\Estudando Programação Avançada\3\gestaoempresarial\target\classes\com\helio\ui\Menu.class", "Java", 0, 22, 0, 0, 22
"c:\Users\helio\OneDrive\Área de Trabalho\Estudando Programação Avançada\3\gestaoempresarial\target\classes\com\helio\ui\MenuTipoContas.class", "Java", 0, 17, 0, 0, 17
"c:\Users\helio\OneDrive\Área de Trabalho\Estudando Programação Avançada\3\gestaoempresarial\target\classes\com\helio\ui\SubmenuContaPoupanca.class", "Java", 0, 66, 0, 1, 67
"c:\Users\helio\OneDrive\Área de Trabalho\Estudando Programação Avançada\3\gestaoempresarial\target\classes\com\helio\ui\SubmenuEmpresa.class", "Java", 0, 39, 0, 0, 39
"c:\Users\helio\OneDrive\Área de Trabalho\Estudando Programação Avançada\3\gestaoempresarial\target\classes\com\helio\ui\SubmenuFuncionarios.class", "Java", 0, 71, 0, 0, 71
"c:\Users\helio\OneDrive\Área de Trabalho\Estudando Programação Avançada\3\gestaoempresarial\target\classes\com\helio\ui\SubmenuPessoa.class", "Java", 0, 57, 0, 0, 57
"c:\Users\helio\OneDrive\Área de Trabalho\Estudando Programação Avançada\3\gestaoempresarial\target\classes\com\helio\utilities\CabecalhoPadrao.class", "Java", 0, 18, 0, 0, 18
"c:\Users\helio\OneDrive\Área de Trabalho\Estudando Programação Avançada\3\gestaoempresarial\target\classes\com\helio\utilities\EntityManagerUtil.class", "Java", 0, 16, 0, 0, 16
"c:\Users\helio\OneDrive\Área de Trabalho\Estudando Programação Avançada\3\gestaoempresarial\target\classes\com\helio\utilities\Pausa.class", "Java", 0, 13, 0, 0, 13
"c:\Users\helio\OneDrive\Área de Trabalho\Estudando Programação Avançada\3\gestaoempresarial\target\classes\com\helio\utilities\ResetaTerminal.class", "Java", 0, 18, 0, 0, 18
"c:\Users\helio\OneDrive\Área de Trabalho\Estudando Programação Avançada\3\gestaoempresarial\target\classes\com\helio\utilities\Validacao.class", "Java", 0, 69, 0, 0, 69
"c:\Users\helio\OneDrive\Área de Trabalho\Estudando Programação Avançada\3\gestaoempresarial\target\test-classes\com\helio\AppTest.class", "Java", 0, 11, 0, 0, 11
"c:\Users\helio\OneDrive\Área de Trabalho\Estudando Programação Avançada\3\gestaoempresarial\target\test-classes\com\helio\ui\SubmenuPessoaTest.class", "Java", 0, 23, 0, 0, 23
"Total", "-", 142, 2360, 60, 454, 3016